1 1 1 1 1 1 1 1 1 1 1 1 1 1 1 1 4 2 2 2 2 5 1 1 1 1 1 1 1 1 1 1 1 1 1 1 1 1 1 1 1 1 1 1 1 1 1 1
1 1 1 1 1 1 1 1 1 1 1 1 1 1 1 1 13 3 3 3 3 14 1 1 1 1 1 1 1 1 1 1 1 1 1 1 1 1 1 1 1 1 1 1 1 1 1 1 
1 1 1 1 1 1 1 1 1 1 1 1 1 1 1 1 13 3 3 3 3 14 1 1 1 1 1 1 1 1 1 1 1 1 1 1 1 1 1 1 1 1 1 1 1 1 1 1 
1 1 1 1 1 1 1 1 1 1 1 1 1 1 1 1 13 3 3 3 3 14 1 1 1 1 1 11 2 2 2 2 2 2 12 1 11 2 2 2 2 2 2 2 12 1 1 1 
1 1 4 2 2 2 2 2 2 12 1 1 1 1 1 1 13 3 3 3 3 14 1 1 1 1 1 9 3 3 3 3 3 3 6 2 7 3 3 3 3 3 3 3 10 1 1 1 
1 1 13 3 3 3 3 3 3 10 1 1 1 1 1 1 13 3 3 3 3 14 1 1 1 1 1 9 3 3 3 3 3 3 3 3 3 3 3 3 3 3 3 3 10 1 1 1 
1 1 13 3 3 3 3 9 3 6 2 2 2 2 2 2 15 3 3 3 3 16 2 2 2 2 2 7 3 3 3 3 3 3 17 21 18 3 3 3 3 3 3 3 10 1 1 1 
1 1 13 3 3 3 3 9 3 26 3 3 3 3 3 3 3 3 3 3 3 3 3 3 3 3 3 3 3 3 3 3 3 3 10 1 9 3 3 3 3 3 3 3 10 1 1 1 
1 1 13 3 3 3 3 9 2 2 2 2 2 2 5 3 4 2 2 2 2 5 3 4 2 2 2 2 2 2 2 5 25 4 23 1 9 3 3 3 3 3 3 3 10 1 1 1 
1 1 6 5 3 4 2 7 1 1 1 1 1 1 9 3 1 2 2 2 2 7 3 10 1 1 1 1 1 1 1 9 3 10 1 1 9 3 3 3 3 3 3 3 10 1 1 1 
1 1 1 9 3 10 1 1 1 1 1 1 1 4 7 3 3 3 3 3 3 3 3 6 2 2 2 2 12 1 1 9 3 10 1 1 9 3 3 3 3 3 3 3 10 1 1 1 
1 1 1 9 3 10 1 1 1 1 1 1 1 13 3 3 3 3 3 3 3 3 3 3 3 3 3 3 10 1 1 9 3 10 1 1 9 3 3 3 3 3 3 3 10 1 1 1 
1 1 1 9 3 10 24 2 2 2 2 5 1 13 3 3 3 3 3 3 3 3 3 3 3 3 3 3 10 1 1 9 3 10 1 1 9 25 4 2 2 2 2 2 23 1 1 1 
1 1 1 9 3 6 7 3 3 3 3 9 1 13 3 3 3 3 3 3 3 3 3 3 3 3 3 3 6 2 5 9 3 10 1 1 9 3 10 1 1 1 1 1 1 1 1 1 
1 1 1 9 3 26 3 3 3 3 3 9 1 13 3 3 3 3 3 3 3 3 3 3 3 3 3 3 26 3 9 9 3 10 1 1 9 3 10 1 1 1 1 1 1 1 1 1 
1 1 1 9 3 4 2 2 2 2 2 7 1 13 3 3 3 3 3 3 3 3 3 3 3 3 3 3 4 2 7 9 3 10 1 1 9 3 10 1 1 1 1 1 1 1 1 1 
1 1 1 9 3 10 1 1 1 1 1 1 1 13 3 3 3 3 3 3 3 3 3 3 3 3 3 3 10 1 1 9 3 10 1 1 9 3 10 1 1 1 1 1 1 1 1 1 
1 1 1 9 3 10 1 1 1 1 1 1 1 6 5 25 4 2 2 5 3 3 4 2 2 2 2 2 10 1 1 9 3 10 24 2 7 3 6 2 2 2 2 2 2 12 1 1 
1 1 1 9 3 10 1 1 1 1 1 1 1 4 7 3 6 5 1 9 3 3 10 1 1 1 1 1 1 1 1 9 3 10 9 3 3 3 3 3 3 3 3 3 3 10 1 1 
1 1 1 9 3 10 24 2 2 5 1 1 1 6 2 2 2 7 1 9 3 3 10 1 1 1 1 1 1 1 1 9 3 10 9 3 3 3 3 3 3 3 3 3 3 10 1 1 
1 1 1 9 3 6 7 3 3 14 1 1 1 1 1 1 1 1 1 9 3 3 10 1 1 1 1 1 1 1 1 9 3 10 9 3 3 3 3 3 3 3 3 3 3 10 1 1 
1 1 1 9 3 26 3 3 3 14 1 24 2 2 2 2 2 2 2 7 3 3 6 2 2 2 5 24 5 1 1 9 3 6 7 3 3 3 3 3 3 3 3 3 3 10 1 1 
1 1 1 9 3 4 5 3 3 14 1 9 3 3 3 3 26 3 3 3 3 3 3 3 3 3 16 7 14 1 1 9 3 3 3 3 3 3 3 3 3 3 3 3 3 10 1 1 
1 1 1 9 3 10 9 3 3 14 1 9 3 3 3 14 2 2 2 5 3 3 3 3 3 3 3 26 14 1 1 9 3 4 5 3 3 3 3 3 3 3 3 3 3 10 1 1 
1 1 1 9 3 10 24 2 2 7 1 9 3 3 3 14 1 1 1 9 3 3 4 2 2 2 2 2 7 1 1 9 3 10 24 2 2 2 2 2 2 2 2 5 25 10 1 1 
1 1 1 9 3 10 1 1 1 1 1 9 3 3 3 14 1 1 1 9 3 3 10 1 1 1 1 1 1 1 1 9 3 10 1 1 1 1 1 1 1 1 1 9 3 10 1 1 
1 1 1 9 3 10 1 1 1 1 1 24 2 2 2 7 1 1 1 9 3 3 10 1 1 1 1 1 1 1 1 9 3 10 1 1 1 1 1 1 1 1 1 9 3 10 1 1 
1 1 1 9 3 10 1 1 1 1 1 1 1 1 1 1 1 1 1 9 3 3 10 1 1 1 1 1 1 1 1 9 3 10 1 1 9 2 2 2 2 2 2 7 3 10 1 1 
1 1 1 9 3 10 1 1 1 1 1 1 1 1 1 1 1 1 1 9 3 3 10 1 1 1 1 1 1 1 1 9 3 10 1 1 9 3 3 3 3 3 3 3 3 10 1 1 
1 1 1 9 3 6 2 2 2 2 2 2 2 2 2 2 2 5 1 9 3 3 10 1 4 2 2 2 5 1 1 9 3 10 1 1 9 3 3 3 3 3 3 3 3 10 1 1 
1 1 1 9 3 3 3 3 3 3 3 26 3 3 3 3 3 14 1 9 3 3 10 1 13 3 3 3 14 1 9 7 3 6 2 2 7 3 3 3 3 3 3 3 3 10 1 1 
1 1 1 9 3 4 2 2 2 2 2 5 3 3 3 3 3 16 2 7 3 3 6 2 14 3 3 3 16 2 7 3 3 3 3 3 3 3 3 3 3 3 3 3 3 10 1 1 
1 1 1 9 3 10 1 1 1 1 1 9 3 3 3 3 3 3 3 3 3 3 3 3 3 3 3 3 3 3 26 3 4 2 2 2 5 3 3 3 3 3 3 3 3 10 1 1 
1 1 1 9 3 10 1 1 1 1 1 9 3 3 3 3 3 14 2 2 2 2 2 2 13 3 3 3 14 2 2 2 23 1 1 1 9 3 3 3 3 3 3 3 3 10 1 1 
1 1 1 9 3 10 1 1 1 1 1 9 3 3 3 3 3 14 1 1 1 1 1 1 13 3 3 3 14 1 1 1 1 1 1 1 24 2 2 2 2 2 2 5 3 10 1 1 
1 1 1 9 3 10 1 1 1 1 1 24 2 2 2 2 2 7 1 1 1 1 1 1 6 2 2 2 7 1 1 1 1 1 1 1 1 1 1 1 1 1 1 9 3 10 1 1 
1 1 1 9 3 10 1 1 1 1 1 1 1 1 1 1 1 1 1 1 1 1 1 1 1 1 1 1 1 1 1 1 1 1 1 1 1 1 1 1 1 1 1 9 3 10 1 1 
1 1 1 9 3 10 1 1 1 1 1 1 1 1 1 1 1 1 1 1 1 1 1 1 1 1 1 1 1 1 1 1 1 1 1 1 1 1 1 1 1 1 1 9 3 10 1 1 
1 1 1 9 3 10 1 1 1 1 1 1 1 1 1 1 1 1 1 1 1 1 1 1 1 1 1 1 1 1 24 2 2 2 2 2 2 2 2 2 2 2 2 7 3 10 1 1 
1 1 1 9 3 6 2 2 2 2 2 2 2 2 12 1 1 24 2 2 2 2 2 2 12 1 1 1 1 1 9 3 3 3 3 3 3 3 3 3 3 3 3 3 3 10 1 1 
1 1 1 9 3 3 3 3 3 3 3 3 3 3 10 1 1 9 3 3 3 3 3 3 10 1 1 1 1 1 9 25 4 2 2 2 5 25 4 2 2 2 2 5 3 10 1 1 
1 1 1 9 3 3 3 3 3 3 4 2 5 25 6 2 2 7 3 3 3 3 3 3 6 2 2 2 2 2 7 3 10 1 1 1 9 3 10 1 1 1 1 9 3 10 1 1 
1 1 1 9 3 3 3 3 3 3 10 1 9 3 3 3 3 3 3 3 3 3 3 3 3 3 3 3 3 3 3 3 10 1 1 1 9 3 6 2 2 2 5 9 3 10 1 1 
1 1 1 9 3 3 3 3 3 3 10 1 24 2 2 2 2 5 3 3 3 3 3 3 4 2 2 2 2 2 2 2 23 1 1 1 9 3 3 3 3 3 9 9 3 10 1 1 
1 1 1 24 2 2 2 2 2 2 23 1 1 1 1 1 1 9 3 3 3 3 3 3 10 1 1 1 1 1 1 1 1 1 1 1 9 3 3 3 3 3 16 7 3 10 1 1 
1 1 1 1 1 1 1 1 1 1 1 1 1 1 1 1 1 24 2 2 2 2 2 2 23 1 1 1 1 1 1 1 1 1 1 1 9 3 3 3 3 3 3 3 3 10 1 1 
1 1 1 1 1 1 1 1 1 1 1 1 1 1 1 1 1 1 1 1 1 1 1 1 1 1 1 1 1 1 1 1 1 1 1 1 24 2 2 2 2 2 2 2 2 23 1 1 
1 1 1 1 1 1 1 1 1 1 1 1 1 1 1 1 1 1 1 1 1 1 1 1 1 1 1 1 1 1 1 1 1 1 1 1 1 1 1 1 1 1 1 1 1 1 1 17
